10.ox
ooo..o....
.ooo.o.oo.
ooo...o.o.
...o....o.
.o..o.o...
..oooo.o..
..oo..o.oo
....o....o
.oo.o.o..o
..........
